###############
# #           #
# # # ######  #
# # # #    #  #
#    #  # #  ##
###           #
#  #       ####
#   # #        
#   # #####   #
#   #         #
#   ###########
#   #   #   # #
#   # #   #   #
#   ########  #
#             #
###############
